'''''~~~'''^^^''''''
''''~~~~~''''^''''''
'''''~~~'''''''''''^
''''''''''''''''''^^
^''''''''''''''''''^
~~''''''''''''''''''
~'''''''''''''''''''
'''''''''''~~'''''''
''''''''''~~~~''''''
^^'''''''''~~''''''^
^~''''''''''''''''^^
~~''''''''''''''''~~
'''''''''''''''''''~
''''''''^^''''''''''
'''''''^^^''''''''''
''''''''^^^''''''''~
''''''''''''''''''~~
'''''''''''''''''''~
''''''''''''''''''''
''''''''^~~^''''''''