`````~~~```^^^``````
````~~~~~````^``````
`````~~~```````````^
``````````````````^^
^``````````````````^
~~``````````````````
~```````````````````
```````````~~```````
``````````~~~~``````
^^`````````~~``````^
^~````````````````^^
~~````````````````~~
```````````````````~
````````^^``````````
```````^^^``````````
````````^^^````````~
``````````````````~~
```````````````````~
````````````````````
````````^~~^````````